0 0 0 0 0 0 0 0 0 1 0 0 0 0 0 0 0 0 0
0 0 0 0 0 0 0 0 0 1 0 0 0 0 0 0 0 0 0
1 0 3 0 0 0 0 8 9 1 0 2 0 0 1 0 0 0 0
0 0 0 0 0 0 0 0 0 1 0 1 2 0 0 0 1 1 0
1 1 1 1 1 1 1 1 1 1 1 1 0 1 1 1 1 1 1
0 0 0 0 1 0 0 0 1 0 0 1 2 0 0 0 1 1 0
0 0 0 0 0 0 0 8 1 0 0 0 0 0 0 0 3 2 0
0 0 0 0 0 0 0 0 1 0 0 0 0 0 0 0 0 0 0
0 0 0 0 0 0 0 0 1 0 0 0 0 0 0 0 0 0 0
0 0 0 0 0 0 0 0 1 0 0 0 0 0 0 0 0 0 0