 10 3  3  3  3  3  9 16 16 16 16 16 16 16 16 16 16 16 16 10  3  3  3  3  3  3  3  3  9
 4  0  0  0  0  0  4 16 16 16 16 16 16 16 16 16 16 16 16  4  0  0  0  0  0  0  0  0  4
 4  0  0  0  0  0  4 16 16 16 16 16 16 16 16 16 16 16 16  4  0  0  0  0  0  0  0  0  4
 4  0  0  0  0  0  4 16 16 16 16 16 16 16 16 16 16 16 16  4  0  0  0  0  0  0  0  0  4
 4  0  0  0  0  0  4 16 16 16 16 16 16 16 16 16 16 16 16  4  0  0  0  0  0  0  0  0  4
 4  3  2  3  3  3  3  3  3  3  3 10 16 16 16 16 16 16 16  4  0  0  0  0  0  0  0  0  4
 4  0  0  0  0  0  0  0  0  0  0  4  3  3  3  3  3  3  3  4  0  0  0  0  0  0  0  0  4
 4  0  0  0  0  0  0  0  0  0  0  4  0  0  0  0  0  0  0  4  0  0  0  0  0  0  0  0  4
 4  0  0  0  0  0  0  0  0  0  0  2  0  0  0  0  0  0  0  2  0  0  0  0  0  0  0  0  4
 8  3  9  0  0  0  0  0  0  0  0  4  0  0  0  0  0  0  0  4  0  0  0  0  0  0  0  0  4
16 16  8  3  3  3  3  3  3  3  3  3  3  3  3  3  3  3  3  3  3  3  3  3  3  3  2  3 11
16 16 16 16 16 16 16 16 16 16 16 16 16 16 16 16 16 16 16 16 16 16 16 16  4  0  0  0  4
16 16 16 16 16 16 16 16 16 16 16 16 16 16 16 16 16 16 16 16 16 16 16 16  4  0  0  0  4
16 16 16 16 16 16 16 16 16 16 16 16 16 16 16 16 16 16 16 16 16 16 16 16  4  0  0  0  4
16 16 16 16 16 16 16 16 16 16 16 16 16 16 16 16 16 16 16 16 16 16 16 16  4  0  0  0  4
16 16 16 16 16 16 16 16 16 16 16 16 16 16 16 16 16 16 16 16 16 16 16 16  4  0  0  0  4
16 16 16 16 16 16 16 16 16 16 16 16 16 16 16 16 16 16 16 16 16 16 16 16  4  0  0  0  4
16 16 16 16 16 16 16 16 16 16 16 16 16 16 16 16 16 16 16 16 16 16 16 16  4  0  0  0  4
16 16 16 16 16 16 16 16 16 16 16 16 16 16 16 16 16 16 16 16 16 16 16 16  4  0  0  0  4
16 16 16 16 16 16 16 16 16 16 16 16 16 16 16 16 16 16 16 16 16 16 16 16  4  0  0  0  4
16 16 16 16 16 16 16 16 16 16 16 16 16 16 16 16 16 16 16 16 16 16 16 16  4  2  2  2  4
16 16 16 16 16 16 16 16 16 16 16 16 16 16 16 16 16 16 16 16 16 10  3  3 11  0  0  0  8  3  3  9
16 16 16 16 16 16 16 16 16 16 16 16 16 16 16 16 16 16 16 16 16  4  0  0  0  0  0  0  0  0  0  4
16 16 16 16 16 16 16 16 16 16 16 16 16 16 16 16 16 16 16 16 16  4  0  0  0  0  0  0  0  0  0  4
16 16 16 16 16 16 16 16 16 16 16 16 16 16 16 16 16 16 16 16 16  4  0  0  0  0  0  0  0  0  0  4
16 16 16 16 16 16 16 16 16 16 16 16 16 16 16 16 16 16 16 16 16  4  0  0  0  0  0  0  0  0  0  4
16 16 16 16 16 16 16 16 16 16 16 16 16 16 16 16 16 16 16 16 16  4  0  0  0  0  0  0  0  0  0  4
16 16 16 16 16 16 16 16 16 16 16 16 16 16 16 16 16 16 16 16 16  4  0  0  0  0  0  0  0  0  0  4
16 16 16 16 16 16 16 16 16 16 16 16 16 16 16 16 16 16 16 16 16  4  0  0  0  0  0  0  0  0  0  4
16 16 16 16 16 16 16 16 16 16 16 16 16 16 16 16 16 16 16 16 16  4  0  0  0  0  0  0  0  0  0  4
16 16 16 16 16 16 16 16 16 16 16 16 16 16 16 16 16 16 16 16 16  4  0  0  0  0  0  0  0  0  0  4
16 16 16 16 16 16 16 16 16 16 16 16 16 16 16 16 16 16 16 16 16  8  3  3  3  3  3  3  3  3  3 11